WWWWWWWWWWWWWWWWWWWWWWWWWWWWWWWWWWWWWWWWWWWWWWWWWWWWWWWWWWWWWWWWWWWWWWWW
W....................WWWWWWWWWWWWWWWWWWWWWWWWWWWWWW....................W
W.WWWWWWWWWWWWWWWWWW.WWWWWWWWWWWWWWWWWWWWWWWWWWWWWW.WWWWWWWWWWWWWWWWWW.W
W.WWWWWWWWWWWWWWWWWW.WWWWWWWWWWWWWWWWWWWWWWWWWWWWWW.WWWWWWWWWWWWWWWWWW.W
W.WWWWWWWWWWWWWWWWWW.WWWWWWWWWWWWWWWWWWWWWWWWWWWWWW.WWWWWWWWWWWWWWWWWW.W
W.WWWWWWWWWWWWWWWWWW.WWWWWWWWWWWWWWWWWWWWWWWWWWWWWW.WWWWWWWWWWWWWWWWWW.W
W.WWWWWWWWWWWWWWWWWW.WWWWWWWWWWWWWWWWWWWWWWWWWWWWWW.WWWWWWWWWWWWWWWWWW.W
W......................................................................W
W.WWWWWWWWWWWWWW.WWWWWWWWW.WWWWWWWWWWWWWWWWWW.WWWWWWWWW.WWWWWWWWWWWWWW.W
W.WWWWWWWWWWWWWW.WWWWWWWWW.WWWWWWWWWWWWWWWWWW.WWWWWWWWW.WWWWWWWWWWWWWW.W
W.WWWWWWWWWWWWWW.WWWWWWWWW.WWWWWWWWWWWWWWWWWW.WWWWWWWWW.WWWWWWWWWWWWWW.W
W.WWWWWWWWWWWWWW.WWWWWWWWW.WWWWWWWWWWWWWWWWWW.WWWWWWWWW.WWWWWWWWWWWWWW.W
W.WWWWWWWWWWWWWW.WWWWWWWWW.WWWWWWWWWWWWWWWWWW.WWWWWWWWW.WWWWWWWWWWWWWW.W
W.WWWWWWWWWWWWWW.WWWWW............................WWWWW.WWWWWWWWWWWWWW.W
W.WWWWWWWWWWWWWW.WWWWW.WWWWWWWWWWooooooWWWWWWWWWW.WWWWW.WWWWWWWWWWWWWW.W
W.WWWWWWWWWWWWWW.WWWWW.WWWWWWWWWWooooooWWWWWWWWWW.WWWWW.WWWWWWWWWWWWWW.W
W.WWWWWWWWWWWWWW.WWWWW.WWWWWWWWWWWWWWWWWWWWWWWWWW.WWWWW.WWWWWWWWWWWWWW.W
W......................WWWWWWWWWWWWWWWWWWWWWWWWWW......................W
WWWWWWWWWWW.WWWWWWWWWW.WWWWWWWWWWWWWWWWWWWWWWWWWW.WWWWWWWWWW.WWWWWWWWWWW
WWWWWWWWWWW.WWWWWWWWWW.WWWWWWWWWWWWWWWWWWWWWWWWWW.WWWWWWWWWW.WWWWWWWWWWW
WWWWWWWWWWW.WWWWWWWWWW.WWWWWWWWWWWWWWWWWWWWWWWWWW.WWWWWWWWWW.WWWWWWWWWWW
WWWWWWWWWWW.WWWWWWWWWW.WWWWWWWWWWWWWWWWWWWWWWWWWW.WWWWWWWWWW.WWWWWWWWWWW
WWWWWWWWWWW.WWWWWWWWWW.WWWWWWWWWWWWWWWWWWWWWWWWWW.WWWWWWWWWW.WWWWWWWWWWW
WWWWWWWWWWW.WWWWWWWWWW.WWWWWWWWWWWWWWWWWWWWWWWWWW.WWWWWWWWWW.WWWWWWWWWWW
W................WWWWW.WWWWWWWWWWWWWWWWWWWWWWWWWW.WWWWW................W
W.WWWWWWWWWWWWWW.WWWWW.WWWWWWWWWWWWWWWWWWWWWWWWWW.WWWWW.WWWWWWWWWWWWWW.W
W.WWWWWWWWWWWWWW.WWWWW............................WWWWW.WWWWWWWWWWWWWW.W
W.WWWWWWWWWWWWWW.WWWWW.WWWWWWWWWWWWWWWWWWWWWWWWWW.WWWWW.WWWWWWWWWWWWWW.W
W.WWWWWWWWWWWWWW.WWWWW.WWWWWWWWWWWWWWWWWWWWWWWWWW.WWWWW.WWWWWWWWWWWWWW.W
W.WWWWWWWWWWWWWW.WWWWW.WWWWWWWWWWWWWWWWWWWWWWWWWW.WWWWW.WWWWWWWWWWWWWW.W
W.WWWWWWWWWWWWWW.WWWWW.WWWWWWWWWWWWWWWWWWWWWWWWWW.WWWWW.WWWWWWWWWWWWWW.W
W.WWWWWWWWWWWWWW.WWWWW.WWWWWWWWWWWWWWWWWWWWWWWWWW.WWWWW.WWWWWWWWWWWWWW.W
W......................................................................W
WWWWWWWWWWWWWWWWWWWWWWWWWWWWWWWWWWWWWWWWWWWWWWWWWWWWWWWWWWWWWWWWWWWWWWWW