WWWWWWWWWWWWWWWWWWWWWWWWWWWWWWWWWWWWWWW
W*....................................W
W.WWWWW...W.....W...W--W..W.....WWWWW.W
W.W......W-W...W-W..WoooW.W.....W.....W
W.W.....W---W.W---W.WoooW.W.....W.....W
W.WWW...WWWWW.WWWWW.WWWW.*W.....WWWW..W
W.W.....W.*.W.W.*.W.W---W.W.....W.....W
W.W.....W...W.W...W.WWWW..WWWWW.WWWWW.W
W....................................*W
WWWWWWWWWWWWWWWWWWWWWWWWWWWWWWWWWWWWWWW